1,1,1,1,1,1,1,1,1,1,1,1,1,1,1,1
1,2,2,2,2,2,2,3,3,2,2,2,2,2,2,1
1,2,d1,0,d1,0,2,2,2,2,d1,0,d1,0,2,1
1,2,0,u1,0,u1,r3,0,0,d3,0,u1,0,u1,2,1
1,2,r2,r2,0,0,0,0,l1,0,r2,r2,0,0,2,1
1,2,0,0,l2,l2,0,r1,0,0,0,0,l2,l2,2,1
1,2,d1,0,d1,0,u3,0,0,l3,d1,0,d1,0,2,1
1,2,0,u1,0,u1,2,2,2,2,0,u1,0,u1,2,1
1,2,2,2,2,2,2,3,3,2,2,2,2,2,2,1
1,1,1,1,1,1,1,1,1,1,1,1,1,1,1,1